10 10
1111111111
1s00100001
1101101101
1000101101
1100001101
1111110001
1111000111
1111010001
11110001e1
1111111111